Wood = Woodward
RUP1 = Regional Utility Plant 1
RUP2 = Regional Utility Plant 2
RUP3 = Regional Utility Plant 3
RUP4 = Regional Utility Plant 4
RUP5 = Regional Utility Plant 5
MilH = ?
Colv = Colvard
AtkiG = Atkins 
Cone = Cone
Came = Cameron
Frid = Friday
Rees = Reese
Robi = Robinson
Pros = Prospector
SVDH = South Village Crossing aka SOVI
Stor = Storrs
McCoC = ?
Smit = Smith
CoEd = Cato College of Education
Faci = Facilities
Grig = Grigg hall
UREC = UREC
MSII = ?
Auxi = Auxiliary Services
MiltA = ?
Tenn =  Tennis Complex
Fret = Fretwell
Wach = ?
SoTF = ?
FOPS = New Facilities Ops and Parking
Denn = Denny
Unio = Student Union
Macy = Macy
Lync = Lynch
StuH = Student Housing???
Burs = Burson
HunH = ?
Levi = Levine
Duke = Duke
BURS = Burson??? there are two for some reason one might be the office of Bursar
Bioi = Bioninformatics
PORT = Portal
Gage = Gage Undergraduate Admissions Center
BelG = Belk Gymnasium
King = King
NERF = ?
Mart = Martin
Hick = Hickory
StuU = ??? maybe student Union?
Cafe = Cafeteria Activities Building
Ceda = Cedar
Rowe = Rowe
Coun = Price Counseling Center
Memo = Memorial hall
Irwi = Irwin Belk Track & Field
BaTF = ?
Kenn = Kennedy
Winn = Winningham
BandCor = Johnson Band Center?
Cato = Cato
Barn = Barnard
Harr = Harris Alumni Center
Laur = Laurel
Syca = Sycamore
JBui = ?
PROS = Prospector again???
With = Witherspoon
Wall = Wallis
EHS = Storage??? not sure what this really is
Scot = Scott
Foun = Foundation
CenC = ?
FacA = Facilities Annex?
CRI = parking?
East = East Deck?
FouA = ?
RE = ?
NCRC = NC research campus
Nine = Niner house?
StuA = Student Activity Center
Epic = Epic

